000000000
011131110
011111110
011111110
011111110
011111110
011111110
011111110
011111320
000000000
1,1