0000000000
0411333330
0411333330
0311333330
0311111130
0311111130
0333331120
0333331140
0000000000
1,2