00000000
04233330
01133330
01133330
01111110
01111110
01111110
01311110
04344430
00000000
4,8