000000000000
033333333330
031131111130
031111111120
041111113130
041311311130
000000000000
1,4