000000000000000000
011111111311111330
011131111111111330
011111111131111330
013111111111111330
031111111311111330
011111111111113330
011111131111111420
011311111111111440
011111111111113330
011111113111111330
011111311131111330
011111111111111330
033333333333334330
000000000000000000
14,13