000000000000
041111141310
011111211310
013341411110
013111141110
013113111110
013114111140
041111111310
011111311310
013411411140
013111114110
013111111310
013141141310
013434434310
013434434310
041444444140
031444444130
000000000000
5,16